####################
#11111111111111111##
#.................##
#..........######.##
#@.........######.##
#.................##
#OOOOOOOOOOO......##
#.#.#.#.#.#.#.#.#.##
#.................##
#.................##
#.................##
####################
