####################
#.................##
#.................##
#..........######.##
#@.........######.##
#.................##
########..........##
#.#.#.#.#.#.#.#.#.##
#.................##
#.................##
#.................##
####################
