####################
#11111111111111111##
#.................##
#............####.##
E@...........####.##
E.................##
#OOOOOOOO.........##
#.#.#.#.#.#.#.#.#.##
#.................##
#.................##
#.................##
####################
