
####################
#..................#
#..................#
W..................#
W@.................#
#..................#
#..................#
####################
