####################
#11111111111111111##
#.................##
#............####.##
#@...........####.##
#..................E
#OOOOOOOO..........E
#.#.#.#.#.#.#.#.#.##
#.................##
#.................##
#.................##
####################
