####################
#..................#
#.P..............P.#
#..................#
W@.................#
W..................#
#..................#
#..................#
#..................#
#.P..............P.#
#..................#
####################