
####################
#..................#
#..................#
W................!.#
W@.................#
#..................#
#..................#
####################
