
####################
#..................#
#..................#
#..................E
#@.................E
#..................#
#..................#
####################
