####################
#11111111111111111##
#.................##
#............####.##
W@...........####.##
W.................##
#OOOOOOOO.........##
#.#.#.#.#.#.#.#.#.##
#.................##
#.................##
#.................##