####################
#..F....FFFFFFFFFFF#
#.PF......FF.....PF#
#..F.FF...FF......F#
W@.F.F.F..FF..F....#
W..F.F....FF..F....#
#..F.F....FF..F....#
#..F.F....FF..F....#
#..F.F....FF..F...F#
#.P..F...........PF#
#....F............F#
####################