####################
#11...............1#
#OO...............1#
#.1.1111111111111.1#
W@1.O.............1#
W.1.O............O.E
#.1.O...1111111OOO.E
#.1.1...1..........#
#.1.O...1..........#
#...1..............#
#...O..............#
####################
