####################
#.....#....#...#...#
#.....#....#...#...#
#.##..#.#....#...#.E
W@##..#.#....#...#.E
W.###.#.############
#.....#.........#..#
#.....#.........#..#
#.########.######.##
#............#....##
#.................##
####################
 