####################
#..A.............P.#
#..................#
#..1.11111111111111#
W@.1O.1.F...F...F..E
W..1....F...F...F..E
#OO.......F...F....#
#11A..1...F...F....#
#FF.FFFFFFFFFFFFFFF#
#..................#
#..................#
####################
