####################
#H................H#
#..................#
#..................#
W@.................#
W...........!......#
#..................#
#..................#
#..................#
#..................#
#H................H#
####################
