####################
#FFF...F...F....FFF#
#..F.......F.....FF#
W....F...F...FF....E
W@F..FFF.F...F.F...E
####################
#111...1...1....111#
#..1.......1.....11#
#....1...1...11....#
#.1..111.1...1.1...#
####################
####################
