####################
#..................#
#..................#
#........A.........E
#@.......A.........E
#..................#
#..................#
####################
